zttzzzzzzzztz
ttzz25522zzzt
tzz65555552zw
wzz555555554z
zz68zzz855z4z
rz6zazaz54zzz
zz5z22zz54zrr
zz55555555zzz
z6555555554zz
z8855555588zz
z5528558255zt
tz88z32188ztt
qtzzz6c4zzttq