zzzz46zzzzzzz
4446z4zz44zzz
44455zzz454zz
66z54zz6455zz
z4z564z4555zz
z46zz545665zz
z4zz6554z45zz
z6zz4554z45zz
z688z555z4485
z6zz645644466
zz4z56455zz6z
zz46432154z4z
zz46z6c4z55zz